7 64
0 0 0 0 0 0 0 0 0 0 0 0 0 0 0 0 0 0 0 0 0 0 0 0 0 0 0 0 0 0 0 0 0 0 0 0 0 0 0 0 0 0 0 0 0 0 0 0 0 0 0 0 0 0 0 0 0 0 0 0 0 0 0 0
1 2 3 2 4 5 3 3 3 3 3 3 3 3 3 3 3 3 3 3 3 3 2 4 5 3 3 3 3 3 2 3 3 2 3 3 3 3 3 3 3 3 3 3 3 3 3 3 3 3 3 3 3 3 3 3 3 3 3 3 3 3 3 3
6 7 8 9 10 11 12 12 13 14 15 16 17 16 18 19 12 12 18 19 12 12 7 10 11 18 19 12 18 19 7 8 20 9 8 21 12 18 19 12 12 18 19 12 12 12 22 23 12 12 24 17 16 25 24 26 14 16 12 27 12 12 18 19
28 29 30 31 31 32 27 33 34 35 36 37 35 37 38 12 12 39 17 16 40 12 29 31 32 12 22 41 41 23 29 30 30 31 30 32 27 12 42 12 22 41 23 27 12 42 43 44 18 45 34 35 37 46 47 36 35 37 38 18 48 17 40 16
49 50 51 52 52 53 50 54 55 55 55 56 55 56 55 57 53 58 59 60 61 62 50 52 53 42 43 63 63 44 50 51 51 52 51 53 50 53 64 65 43 63 44 65 42 64 43 44 50 54 55 55 56 55 56 55 55 56 55 53 58 59 61 60
66 67 67 67 67 67 67 67 67 67 67 67 67 67 67 67 68 69 70 69 70 69 70 69 70 64 43 63 63 44 69 69 71 72 69 73 67 67 74 67 75 76 77 68 64 64 43 44 69 69 78 69 78 69 78 69 73 67 67 67 67 67 67 67
79 80 80 80 80 80 80 80 80 80 80 80 80 80 80 80 81 69 82 69 82 69 82 69 82 82 83 84 84 85 69 69 83 82 69 86 80 80 80 80 80 80 80 81 82 82 83 85 69 69 87 69 87 69 87 69 86 80 80 80 80 80 80 80
40 4
52
0 0 40 544 24 2 5 0
0 576 40 32 8 2 11 0
0 640 40 32 8 2 12 0
0 704 40 32 8 2 14 0
0 768 40 32 8 2 15 0
0 800 72 32 8 2 15 1
0 832 104 128 8 2 17 1
0 1024 40 64 8 2 20 0
0 1120 40 288 24 2 24 0
0 1216 104 32 8 2 24 1
0 1280 104 96 8 2 25 1
0 1408 72 32 8 2 27 1
0 1440 104 32 8 2 28 1
0 1472 136 64 8 2 29 2
0 1600 40 16 8 2 31 0
0 1664 40 16 8 2 32 0
0 1728 40 16 8 2 33 0
0 1792 40 240 24 2 37 0
1 240 72 32 32 1 5 1
1 288 72 32 32 1 5 1
1 336 72 32 32 1 6 1
1 432 72 32 32 1 8 1
1 1280 136 32 32 1 25 2
1 1440 136 32 32 1 28 2
1 1472 168 32 32 1 29 2
1 1872 72 32 32 1 36 1
1 1952 72 32 32 1 38 1
2 224 56 32 16 0 4 0
2 928 120 32 16 0 18 2
2 896 120 32 16 1 17 2
2 1264 56 32 16 1 25 0
3 800 104 32 32 1 15 1
3 1200 136 32 32 1 23 2
4 544 160 32 24 1 10 2
4 704 160 32 24 1 14 2
4 1040 144 32 24 0 20 2
4 1552 144 32 24 0 30 2
4 1712 160 32 24 1 33 2
4 1856 160 32 24 1 36 2
5 1360 72 32 32 1 26 1
6 320 88 32 16 1 6 1
6 416 88 32 16 1 8 1
7 560 88 32 16 1 11 1
7 1136 88 32 16 1 22 1
7 1312 152 32 16 1 25 2
8 1840 88 32 16 1 36 1
9 880 152 32 16 1 17 2
10 624 104 32 16 1 12 1
11 1648 88 32 16 1 32 1
12 752 120 32 16 1 15 2
14 1168 152 32 16 1 23 2
20 624 72 16 16 0 12 1