7 96
0 0 0 0 0 0 0 0 0 0 0 0 0 0 0 0 0 0 0 0 0 0 0 0 0 0 0 0 0 0 0 0 0 0 0 0 0 0 0 0 0 0 0 0 0 0 0 0 0 0 0 0 0 0 0 0 0 0 0 0 0 0 0 0 0 0 0 0 0 0 0 0 0 0 0 0 0 0 0 0 0 0 0 0 0 0 0 0 0 0 0 0 0 0 0 0
1 1 1 1 1 1 1 1 2 3 1 1 1 1 1 2 3 1 1 1 1 4 1 1 1 1 1 1 1 2 3 1 1 1 1 1 1 4 1 1 1 1 2 3 1 1 1 1 1 2 3 1 1 1 1 1 1 1 1 1 1 1 1 1 2 3 1 1 1 4 1 1 1 1 1 1 1 1 1 1 1 1 1 1 1 1 1 2 3 1 1 1 1 4 1 5
6 6 6 6 7 6 6 6 8 9 6 7 6 6 6 8 9 6 10 11 11 12 13 6 6 6 6 7 6 8 9 6 6 6 14 11 13 15 10 11 13 6 8 9 6 6 7 6 6 8 16 11 11 11 13 6 17 18 6 14 13 6 6 6 8 9 6 6 6 15 6 6 6 6 6 17 18 6 6 6 6 6 19 18 6 6 6 8 9 6 6 6 6 15 6 20
6 17 18 6 15 6 6 6 6 6 6 15 6 10 11 11 11 11 21 22 22 22 23 6 17 18 6 15 6 24 6 7 6 25 26 22 23 6 27 22 28 29 11 11 11 11 12 11 11 11 21 22 22 22 23 6 8 9 25 26 23 6 6 6 6 6 6 10 11 13 6 17 18 6 6 8 9 6 6 7 6 6 8 9 6 10 11 11 11 13 6 17 18 6 6 20
6 8 9 6 6 6 17 18 10 11 11 11 11 21 22 22 22 22 30 30 30 30 31 6 8 9 6 24 6 32 6 15 6 6 33 30 34 6 35 30 36 37 22 22 22 22 38 37 22 22 30 30 30 30 39 40 41 40 40 33 31 40 24 41 10 11 11 21 22 23 6 8 9 10 13 6 6 6 10 12 13 6 6 10 11 21 22 22 22 23 6 8 9 6 6 42
11 11 11 11 11 11 43 44 21 22 22 22 22 30 30 30 30 30 30 30 30 30 31 41 40 24 40 32 40 45 29 11 11 11 46 30 36 11 47 30 48 49 30 36 47 30 48 49 30 36 50 50 47 51 52 53 54 55 53 33 31 53 32 54 27 22 22 30 30 31 29 11 11 21 28 29 11 11 21 22 28 29 11 21 22 30 30 30 30 31 41 40 10 11 11 56
22 22 22 22 22 22 22 22 30 30 30 30 30 30 30 30 30 30 30 30 30 30 31 54 53 32 53 57 53 20 22 22 22 22 30 30 48 49 49 30 30 30 30 48 49 30 30 30 30 48 49 49 49 31 58 58 58 32 58 59 31 58 57 58 20 30 30 30 30 30 22 22 22 30 30 22 22 22 30 30 30 22 22 30 30 30 30 30 30 31 54 53 27 22 22 60
