7 96
0 0 0 0 0 0 0 0 0 0 0 0 0 0 0 0 0 0 0 0 0 0 0 0 0 0 0 0 0 0 0 0 0 0 0 0 0 0 0 0 0 0 0 0 0 0 0 0 0 0 0 0 0 0 0 0 0 0 0 0 0 0 0 0 0 0 0 0 0 0 0 0 0 0 0 0 0 0 0 0 0 0 0 0 0 0 0 0 0 0 0 0 0 0 0 0
1 1 1 1 1 1 1 1 2 3 1 1 1 1 1 2 3 1 1 1 1 4 1 1 1 1 1 1 1 2 3 1 1 1 1 1 1 4 1 1 1 1 2 3 1 1 1 1 1 2 3 1 1 1 1 1 1 1 1 1 1 1 1 1 2 3 1 1 1 4 1 1 1 1 1 1 1 1 1 1 1 1 1 1 1 1 1 2 3 1 1 1 1 4 1 5
6 6 6 6 7 6 6 6 8 9 6 7 6 6 6 8 9 6 10 11 11 12 13 6 6 6 6 7 6 8 9 6 6 6 14 11 13 15 10 11 13 6 8 9 6 6 7 6 6 8 16 11 11 11 13 6 17 18 6 14 13 6 6 6 8 9 6 6 6 15 6 6 6 6 6 17 18 6 6 6 6 6 19 18 6 6 6 8 9 6 6 6 6 15 6 20
6 17 18 6 15 6 6 6 6 6 6 15 6 10 11 11 11 11 21 22 22 22 23 6 17 18 6 15 6 24 6 7 6 25 26 22 23 6 27 22 28 29 11 11 11 11 12 11 11 11 21 22 22 22 23 6 8 9 25 26 23 6 6 6 6 6 6 10 11 13 6 17 18 6 6 8 9 6 6 7 6 6 8 9 6 10 11 11 11 13 6 17 18 6 6 20
6 8 9 6 6 6 17 18 10 11 11 11 11 21 22 22 22 22 30 30 30 30 31 6 8 9 6 24 6 32 6 15 6 6 33 30 34 6 35 30 36 37 22 22 22 22 38 37 22 22 30 30 30 30 39 40 41 40 40 33 31 40 24 41 10 11 11 21 22 23 6 8 9 10 13 6 6 6 10 12 13 6 6 10 11 21 22 22 22 23 6 8 9 6 6 42
11 11 11 11 11 11 43 44 21 22 22 22 22 30 30 30 30 30 30 30 30 30 31 41 40 24 40 32 40 45 29 11 11 11 46 30 36 11 47 30 48 49 30 36 47 30 48 49 30 36 50 50 47 51 52 53 54 55 53 33 31 53 32 54 27 22 22 30 30 31 29 11 11 21 28 29 11 11 21 22 28 29 11 21 22 30 30 30 30 31 41 40 10 11 11 56
22 22 22 22 22 22 22 22 30 30 30 30 30 30 30 30 30 30 30 30 30 30 31 54 53 32 53 57 53 20 22 22 22 22 30 30 48 49 49 30 30 30 30 48 49 30 30 30 30 48 49 49 49 31 58 58 58 32 58 59 31 58 57 58 20 30 30 30 30 30 22 22 22 30 30 22 22 22 30 30 30 22 22 30 30 30 30 30 30 31 54 53 27 22 22 60
77
0 0 40 256 8 2
0 256 72 160 32 2
0 416 104 160 32 2
0 576 136 160 136 0
0 800 40 32 40 2
0 864 72 32 72 2
0 928 104 32 104 2
0 960 40 128 8 2
0 1090 136 64 8 2
0 1168 136 16 64 0
0 1216 136 16 64 1
0 1232 136 80 32 2
0 1152 40 96 24 2
0 1280 72 64 24 2
0 1312 104 288 8 2
0 1472 72 64 24 2
0 1376 40 64 24 2
0 1568 40 128 24 2
0 1600 136 160 48 0
0 1824 40 32 40 2
0 1890 136 48 136 0
0 1984 72 32 72 2
0 2048 72 96 72 1
0 2144 104 96 64 0
0 2240 40 96 8 2
0 2336 72 64 32 2
0 2400 40 96 8 2
0 2496 72 96 32 2
0 2592 40 64 8 2
0 2656 72 64 32 2
0 2720 104 160 104 0
0 2944 40 112 40 1
18 1856 104 32 8 0
18 1056 104 32 8 0
1 288 104 32 32 1
1 384 104 32 32 1
1 1152 72 32 32 1
1 1216 72 32 32 1
1 864 104 32 32 1
1 1888 168 32 32 1
1 2960 72 32 32 1
2 2728 120 24 16 0
15 512 128 24 24 1
15 640 160 24 24 1
15 1480 96 24 24 1
15 2080 96 24 24 1
15 2272 64 32 24 1
15 2464 64 24 24 1
15 2672 96 24 24 1
16 1576 136 16 32 1
16 1656 168 16 32 1
16 1608 168 24 32 0
3 1056 72 24 32 0
3 1152 168 32 32 0
4 2984 176 24 24 1
4 2672 176 16 24 1
4 2400 176 16 24 1
4 1416 176 24 24 1
4 1440 192 16 24 0
4 904 192 24 24 1
6 344 120 16 16 1
7 440 152 16 16 1
8 696 168 16 16 1
13 1000 152 16 16 1
7 1144 88 16 16 1
9 1384 152 16 16 1
6 1496 152 16 16 1
14 1672 104 16 16 1
8 1816 88 16 16 1
9 2072 136 16 16 1
6 2184 152 16 16 1
7 2360 120 16 16 1
8 2488 120 16 16 1
13 2616 136 16 16 1
7 2824 152 16 16 1
17 1088 136 8 96 1
17 1888 136 8 120 1